PAI = "countries/Paraíba.txt"
JCL = "countries/Lacerdas Brazil.txt" 
JCS = "countries/Costas Brazil.txt" 
JEG = "countries/Geisels Brazil.txt" 
JGD = "countries/Dutras Brazil.txt" 
JRM = "countries/Mazzillis Brazil.txt" 
XIN = "countries/Xingu.txt"
MNH = "countries/Maranhão.txt"
PIA = "countries/Piauí.txt"
CEA = "countries/Ceará.txt"
RGN = "countries/Rio Grande do Norte.txt"
PEB = "countries/Pernambuco.txt"
ALA = "countries/Alagoas.txt"
SEG = "countries/Sergipe.txt"
RPB = "countries/Republica Baiana.txt"
VAL = "countries/Vale.txt"
RMI = "countries/Revolta Mineira.txt"
JUN = "countries/Junta Militar.txt"
CRJ = "countries/CMRJ.txt"
SAO = "countries/São Paulo.txt"
PAU = "countries/Revolta Paulista.txt"
PIR = "countries/Piracicaba.txt"
PAM = "countries/Panama Coup.txt"
USR = "countries/United States Remnants.txt"
MNS = "countries/Manaus.txt"
ACR = "countries/Acre.txt"
JUV = "countries/Juventud.txt"
WAS = "countries/Wasteland.txt"
ERN = "countries/Ejército Revolucionario del Norte.txt"
UBA = "countries/Ubatuba.txt"
CNU = "countries/Canudos.txt"
LAM = "countries/Lampião.txt"
JAG = "countries/Jagunços.txt"
NEB = "countries/Neblina.txt"
AMA = "countries/Amapá.txt"
ROR = "countries/Roraima.txt"
QPM = "countries/Quatro Povos das Missões.txt"
FBO = "countries/Fonte Boa.txt"
ARI = "countries/Aripuanã.txt"
JUT = "countries/Jutaí.txt"
IQU = "countries/Iquiri.txt"
JAV = "countries/Javari.txt"
JUR = "countries/Jurua.txt"
FAK = "countries/Falklands.txt"
STR = "countries/Santarém.txt"
YAN = "countries/Yanomami.txt"
WAI = "countries/Waiãpi.txt"
ZOE = "countries/Zoe.txt"
PAT = "countries/Paritins.txt"
BEM = "countries/Belém.txt"
JAU = "countries/Jaú.txt"
KAY = "countries/Kayapó.txt"
TRO = "countries/Trombetas.txt"
MAP = "countries/Mapueira.txt"
NHA = "countries/Nhamundá.txt"
WAM = "countries/Waimiri.txt"
ATR = "countries/Atroari.txt"
BIA = "countries/Biá.txt"
HIM = "countries/Hi-Merimã.txt"
DNI = "countries/Deni.txt"
MUN = "countries/Mundukuru.txt"
COA = "countries/Coata.txt"
ANI = "countries/Andirá.txt"
MRU = "countries/Marau.txt"
COR = "countries/Coari.txt"
KEY = "countries/Key West.txt"
VEJ = "countries/Venezuelan Junta.txt"
VEC = "countries/Venezuelan Commies.txt"
CIA = "countries/CIA.txt"
ELD = "countries/El Dorado.txt"
LLA = "countries/Llaneros.txt"
LHA = "countries/La Hacienda.txt"
ELN = "countries/ELN.txt"
FAR = "countries/FARN.txt"
CLA = "countries/Colombian Army.txt"
LBT = "countries/Libertadores.txt"
CFD = "countries/Confederação Nordeste.txt"
BMF = "countries/Brazilian Monarchist Front.txt"
MAL = "countries/Male Revolt.txt"
PCR = "countries/PCR.txt"
CAN = "countries/Cangaceiros.txt"
ACC = "countries/Anti Communist Caribbean.txt"
CUP = "countries/Cuban Pirates.txt"
NEH = "countries/New Havana.txt"
SCR = "countries/Santa Cruz.txt"
CDR = "countries/Cuban Revolution Defense.txt"
ECR = "countries/Escambray Rebellion.txt"
BTA = "countries/Batista's Army.txt"
DRE = "countries/Directorio Revolucionario Estudantil.txt"
RED = "countries/Red Army.txt"
RUM = "countries/Rum.txt"
HIE = "countries/Holy Inca Empire.txt"
INC = "countries/Inca Empire.txt"
NCA = "countries/New Castille.txt"
RPE = "countries/Republican Peru.txt"
PMI = "countries/Peruvian Armed Forces.txt"
UFO = "countries/UFO People.txt"
NLA = "countries/National Liberation Army.txt"
FCP = "countries/Federacion Campesina del Peru.txt"
UNO = "countries/UNO.txt"
SEC = "countries/Socialist Republic of Ecuador.txt"
RON = "countries/Rondônia.txt"
MAN = "countries/La Manada.txt"
DEA = "countries/Death Squads.txt"
TUP = "countries/Tupamaros.txt"
ERP = "countries/ERP.txt"
ONG = "countries/Ongania.txt"
GAU = "countries/Gaucho Raiders.txt"
MON = "countries/Montoneros.txt"
DEO = "countries/Deodolindo.txt"
UEL = "countries/Ueltschi.txt"
MAS = "countries/Massera.txt"
BUE = "countries/Buenos Aires Anarchy.txt"
CRR = "countries/Corrientes.txt"
TEF = "countries/Tefé.txt"
KAT = "countries/Acrean Natives.txt"
INT = "countries/Intentona.txt"
#####################################
ENG = "countries/United Kingdom.txt"
SOV = "countries/Soviet Union.txt"
FRA	= "countries/France.txt"
HOL	= "countries/Holland.txt"
ARG = "countries/Argentina.txt"
BOL = "countries/Bolivia.txt"
BRA = "countries/Brazil.txt"
CHL = "countries/Chile.txt"
COL = "countries/Colombia.txt"
COS = "countries/Costa Rica.txt"
ECU = "countries/Ecuador.txt"
GUA = "countries/Guatemla.txt"
HON = "countries/Honduras.txt"
HNL = "countries/FPRLZ.txt"
HNR = "countries/FNLH.txt"
HNM = "countries/Honduran Military.txt"
NIC = "countries/Nicaragua.txt"
PAN = "countries/Panama.txt"
PRU = "countries/Peru.txt"
URG = "countries/Uruguay.txt"
VEN = "countries/Venezula.txt"
PAR = "countries/Paraguay.txt"
CUB = "countries/Cuba.txt"
DOM = "countries/Dominican Republic.txt"
HAI = "countries/Haiti.txt"
BAH = "countries/Bahamas.txt"
GDL = "countries/Guadeloupe.txt"
JAM = "countries/Jamaica.txt"
CAY = "countries/Cayenne.txt"

## MEXICO ##
MEX = "countries/Mexico.txt"
NGA = "countries/Nueva Galicia.txt"
ERE = "countries/Erendira.txt"
AMP = "countries/AMP.txt"
AMG = "countries/AMG.txt"
ESH = "countries/ESH.txt"
ZAP = "countries/Zapatistas.txt"
TAB = "countries/Tabasco.txt"
EJR = "countries/Ejército Cívico Revolucionario.txt"
ERG = "countries/Fuerzas Armadas Rebeldes.txt"
NAM = "countries/Namara.txt"
ESC = "countries/Estado Cristero.txt"
MTR = "countries/Monterrey.txt"
PHF = "countries/Phoenix Force.txt"
USW = "countries/Western Military Command.txt"
LEB = "countries/LeBaron.txt"
HAL = "countries/Los Halcones.txt"
NNM = "countries/New Mexico.txt"
USA = "countries/American Military Command.txt"

# El Salvador #
ELS = "countries/El Salvador.txt"
FML = "countries/FMLN.txt"
SEP = "countries/Salvadoran ERP.txt"
